00003000000-
00012000000-
00020003000-
00000100000-
00030002000-
00000021000-
00000030000